NO S
 C 255,0,0
EA S
	WE S
F 255,0,0 
	SO S 


111111111
111    11
 111110111
110W011111
  1111100001111
11         1111
111111111111
