NO S
 C 255,0,0
EA S
		WE Sada
			WE Sada





F 255,0,0

SO djfhd


111111111111
11111111111111111
111110111111
  111110W011111001
111110001
111111111111
111111111111
