NO S
 C 255,0,0
EA S
		WE Sada





F 255,0,0

SO djfh

        1111111111111111111111111
        1000000000110000000000001
        1011000001110000000000001
        1001000000000000000000001
111111111011000001110000000000001
100000000011000001110111111111111
11110111111111011000000010001
1111011	111111101110101001001
11000011111101011100000010001
10000000000000001100000010001
10000000000000001101010010001
11000001111111011111111110N01111111
1111011101110101 111111010001
11111111 1111111 111111111111
